0;0;4;3;5;3;2;1
0;4;3;2;1;2;3;5
0;4;3;2;3;5;5;5;5;5;5;5;5;5;5;5;5;5;5;5;5;5;5;5;5;5;5;5;5;5;5;5;5;5;5;5;5;5;5;5;5;5;5;5;5;5;5;5;5;5;5;5;5;5;5;5;5;5;5;5;5;5;5;5;5;5;5;5;5;5;5;5;5;5;5;5;5;5;5;5;5;5;5;5;5;5;5;5;5;5;5;5;5;5;5;5;5;5;5;5;5;5;5;5;5;5;5;5;5;5;5;5;5;5;5;5;5;5;5;5;5;5;5;5;5;5;5;5;5;5;5;5;5;5;5;5;5;5;5;5;5;5;5;5;5;5;5;5;5;5;5;5;5;5;5;5;5;5;5;5;5;5;5;5;5;5;5;5;5;5;5;5;5;5;5;5;5;5;5;5;5;5;5;5;5;5;5;5;5;5;5;5;5;5;5;5;5;5;5;5;5;5;5;5;5;5;5;5;5;5;5;5;5;5;5;5;5;5;5;5;5;5;5;5;5;5;5;5;5;5;5;5;5;5;5;5;5;5;5;5;5;5;5;5;5;5;5;5;5;5;5;5;5;5;5;5;5;5;5;5;5;5;5;5;5;5;5;5;5;5;5;5;5;5;5;5;5;5;5;5;5;5;5;5;5;5;5;5;5;5;5;5;5;5;5;5;5;5;5;5;5;5;5;5;5;5;5;5;5;5;5;5;5;5;5;5;5;5;5;5;5;5;5;5;5;5;5;5;5;5;5;5;5;5;5;5;5;5;5;5;5;5;5;5;5;5;5;5;5;5;5;5;5;5;5;5;5;5;5;5;5;5;5;5;5;5;5;5;5;5;5;5;5;5;5;5;5;5;5;5;5;5;5;5;5;5;5;5;5;5;5;5;5;5;5;5;5;5;5;5;5;5;5;5;5;5;5;5;5;5;5;5;5;5;5;5;5;5;5;5;5;5;5;5;5;5;5;5;5;5;5;5;5;5;5;5;5;5;5;5;3;3;3;3;3;3;3;3;3;3;3;3;3;3;3;3;3;3;3;3;3;3;3;3;3;3;3;3;3;4;4;4;4;0;4;4;4;0;0;4;4;4;4;4;0;4;0;0;0;4;4;4;4;0;4;4;3;3;3;3;3;3;3;3;3;3;3;3;3;3;3;3;3;3;3;3;3;3;3;3;3;3;3;3;3;3;3;3;3;3;3;3;3;3;3;3;3;3;3;3;3;3;3;3;3;3;3;3;3;3;3;3;4;4;4;4;0;4;4;4;0;4;0;0;0;0;4;0;0;4;0;0;0;4;4;0;4;0;4;0;4;0;4;0;0;0;4;0;0;4;4;4;0;4;4;4;4;4;0;0;0;4;4;0;4;4;4;0;0;0;0;4;0;4;0;4;4;4;0;4;4;4;4;0;0;4;4;4;0;4;4;4;0;4;0;0;0;4;4;0;4;0;4;0;0;4;0;0;0;4;0;4;4;0;4;4;0;4;0;0;4;0;0;4;0;4;4;0;0;4;4;0;4;4;4;0;0;4;0;0;0;4;4;0;4;4;4;0;4;4;4;0;4;4;4;4;4;4;0;0;4;0;4;4;0;0;0;4;4;4;0;4;0;4;0;4;0;4;0;4;4;0;0;4;4;0;0;4;4;0;4;4;4;4;4;0;0;4;4;4;4;4;0;4;0;0;4;4;4;0;0;4;4;4;0;4;0;4;0;4;0;0;4;0;0;0;0;4;0;0;4;4;0;4;0;0;4;4;4;0;4;4;0;4;0;0;0;4;0;0;0;0;0;4;4;0;0;4;4;0;4;0;4;4;0;4;0;4;4;0;4;4;4;0;0;0;0;0;0;4;4;4;0;4;4;0;4;0;4;4;0;0;4;0;4;4;4;4;4;4;4;4;0;0;4;4;4;0;4;4;0;0;4;4;4;0;4;0;4;0;4;0;0;0;0;4;4;0;4;4;0;0;4;4;4;0;4;0;4;0;0;4;4;0;4;4;0;4;4;4;0;4;0;4;0;4;4;4;4;4;4;4;4;4;0;0;0;4;0;0;0;4;4;0;4;4;0;0;4;0;0;0;0;4;4;4;4;4;0;4;4;4;0;0;4;0;0;4;4;4;0;0;4;4;4;0;0;4;4;0;4;4;4;4;0;4;0;0;0;4;4;4;4;0;4;4;0;0;0;0;4;0;0;4;0;0;4;0;4;4;4;0;0;0;0;4;0;4;0;0;4;0;4;4;0;0;0;4;4;0;0;0;0;4;0;0;0;0;4;0;0;4;4;4;0;0;0;0;4;0;0;0;0;0;4;4;0;0;4;4;0;4;0;4;0;0;4;4;0;0;4;4;0;0;4;0;4;0;0;4;0;4;0;4;4;4;4;4;4;0;4;4;0;0;4;0;4;0;4;0;0;4;4;4;0;4;0;0;4;4;4;4;0;0;4;0;4;4;4;0;4;0;4;0;4;4;4;4;0;0;0;4;4;4;4;0;0;4;4;4;4;0;4;0;0;4;0;0;4;4;4;0;0;4;0;0;0;0;0;4;4;4;0;0;4;3;3;3;3;3;2;1
0;4;3;2;1;2;3;5
0;4;3;5;3;2;1
0;4;3;2;3;5;5;5;5;5;5;5;5;5;5;5;5;5;5;5;5;5;5;5;5;5;5;5;5;5;5;5;5;5;5;5;5;5;5;5;5;5;5;5;5;5;5;5;5;5;5;5;5;5;5;5;5;5;5;5;5;5;5;5;5;5;5;5;5;5;5;5;5;5;5;5;5;5;5;5;5;5;5;5;5;5;5;5;5;5;3;3;3;3;3;3;3;3;3;3;3;3;3;3;3;3;3;3;3;3;3;3;3;2;1
0;4;3;5;3;2;1
0;4;0;4;3;2;1;2;3;5
0;4;3;5;3;2;1
0;4;3;5;3;2;1
2000;41.7693;41

