0;0;4;3;5;3;2;1
0;4;3;2;1;2;3;5
0;4;3;2;3;5;4;3;4;3;2;1
0;4;3;2;1;2;3;5
0;4;3;5;3;2;1
0;4;3;2;3;5;3;2;1
0;4;3;5;3;2;1
0;4;0;4;3;2;1;2;3;5
0;4;3;5;3;2;1
0;4;3;5;3;2;1
2000;41.7693;41

