0;3;5;5;3;2;2;1;2;3;4
0;3;4;3;2;1;2;3;5
0;3;2;1;2;3;5;3;4
0;3;5;3;4;3;2;1
0;3;2;1;2;3;4;3;5
0;3;2;1;2;3;5;3;4
0;3;2;1;2;3;5;3;4
0;3;2;1;2;3;5;3;4
0;3;4;3;5;3;2;1
0;3;4;3;5;3;4;3;0;3;2;1
2000;40.1493;27
39.9921
40.2081
39.9921
41.9241
40.2081
39.9921
39.9921
39.9921
41.9241
37.2681
40.1493

