0;2;3;5;3;4;3;2;1
0;2;3;5;3;4;3;2;1
0;2;3;5;3;4;3;4;3;2;1
0;2;3;5;3;4;3;5;3;5;3;2;1
0;2;3;4;4;3;5;3;4;3;2;1
0;0;2;3;4;3;5;3;4;3;4;3;4;3;2;1
0;2;3;5;3;4;3;5;3;2;1
0;2;3;5;3;4;3;5;3;3;2;1
0;2;2;3;4;3;5;3;;3;2;1
0;2;3;5;5;3;4;3;5;3;4;3;2;2;1
2000;33.4858;470

