0;2;3;5;3;4;3;2;1
0;2;3;5;3;4;3;2;1
0;2;3;5;3;4;3;4;3;2;1
0;2;3;5;3;4;3;5;3;5;3;2;1
0;2;3;4;4;3;5;3;4;3;2;1
0;0;2;3;4;3;5;3;4;3;4;3;4;3;2;1
0;2;3;5;3;4;3;5;3;2;1
0;2;3;5;3;4;3;5;3;3;2;1
0;2;3;4;3;5;3;5;3;2;1
0;2;3;5;5;3;4;3;5;3;4;3;2;2;1
2000;33.4858;470
39.3322
39.3322
34.6762
29.1562
34.6762
25.3642
34.2442
34.2442
34.2442
29.5882
33.4858

