0;0;5;3;2;1;2;3;4
0;0;5;3;2;1;2;3;4
0;5;3;5;5;3;4;3;2;1
0;5;3;2;1;2;3;4
0;5;3;2;1;2;3;4
0;5;3;2;1;1;2;3;2;3;4
0;5;3;2;1;2;3;4
0;5;3;4;3;2;1
0;5;3;4;3;2;1
0;5;3;4;3;2;1
2000;42.2817;20
